....................
....................
...................C
.....###............
....................
.............C......
.....F..............
...........CCC......
...........###......
......CCC..B.........
......###.......CCC.
..C.............###.
.###................
....................
####################
